════╗╔══════║....║......
....║║......║....║.█....
.╔══╬╝..╔═══╣..█╗║.║....
.║..║...║...╚═╦═╝╚╦╝....
.╚╦═╩═══╣.....║...║.....
..║.....║.....╚═══╩═════